6 10
WWWSWWWWWW
W........W
W........W
WW....W..W
W......W.W
WEWWWWWWWW